"filename", "language", "Java", "XML", "comment", "blank", "total"
"d:\git\CoinTenokProject\tenok-coin\pom.xml", "XML", 0, 115, 8, 8, 131
"d:\git\CoinTenokProject\tenok-coin\src\main\java\log4j.xml", "XML", 0, 22, 5, 5, 32
"d:\git\CoinTenokProject\tenok-coin\src\main\java\org\tenok\coin\App.java", "Java", 11, 0, 0, 11, 22
"d:\git\CoinTenokProject\tenok-coin\src\main\java\org\tenok\coin\data\BybitRestDAO.java", "Java", 290, 0, 6, 36, 332
"d:\git\CoinTenokProject\tenok-coin\src\main\java\org\tenok\coin\data\CoinDataAccessable.java", "Java", 18, 0, 3, 3, 24
"d:\git\CoinTenokProject\tenok-coin\src\main\java\org\tenok\coin\data\RealtimeAccessable.java", "Java", 3, 0, 0, 3, 6
"d:\git\CoinTenokProject\tenok-coin\src\main\java\org\tenok\coin\data\entity\InstrumentInfo.java", "Java", 5, 0, 0, 3, 8
"d:\git\CoinTenokProject\tenok-coin\src\main\java\org\tenok\coin\data\entity\OrderDataAccessable.java", "Java", 5, 0, 0, 2, 7
"d:\git\CoinTenokProject\tenok-coin\src\main\java\org\tenok\coin\data\entity\Orderable.java", "Java", 15, 0, 23, 8, 46
"d:\git\CoinTenokProject\tenok-coin\src\main\java\org\tenok\coin\data\entity\WalletAccessable.java", "Java", 7, 0, 0, 2, 9
"d:\git\CoinTenokProject\tenok-coin\src\main\java\org\tenok\coin\data\entity\impl\ActiveOrder.java", "Java", 51, 0, 0, 19, 70
"d:\git\CoinTenokProject\tenok-coin\src\main\java\org\tenok\coin\data\entity\impl\BybitInstrumentInfo.java", "Java", 24, 0, 0, 9, 33
"d:\git\CoinTenokProject\tenok-coin\src\main\java\org\tenok\coin\data\entity\impl\BybitWalletInfo.java", "Java", 29, 0, 0, 10, 39
"d:\git\CoinTenokProject\tenok-coin\src\main\java\org\tenok\coin\data\entity\impl\Candle.java", "Java", 96, 0, 0, 28, 124
"d:\git\CoinTenokProject\tenok-coin\src\main\java\org\tenok\coin\data\entity\impl\CandleList.java", "Java", 114, 0, 4, 31, 149
"d:\git\CoinTenokProject\tenok-coin\src\main\java\org\tenok\coin\data\entity\impl\ConditionOrder.java", "Java", 3, 0, 0, 3, 6
"d:\git\CoinTenokProject\tenok-coin\src\main\java\org\tenok\coin\data\entity\impl\OrderedList.java", "Java", 6, 0, 0, 5, 11
"d:\git\CoinTenokProject\tenok-coin\src\main\java\org\tenok\coin\data\entity\impl\Position.java", "Java", 17, 0, 0, 4, 21
"d:\git\CoinTenokProject\tenok-coin\src\main\java\org\tenok\coin\data\entity\impl\PositionList.java", "Java", 8, 0, 0, 5, 13
"d:\git\CoinTenokProject\tenok-coin\src\main\java\org\tenok\coin\data\impl\AuthDecryptor.java", "Java", 152, 0, 28, 22, 202
"d:\git\CoinTenokProject\tenok-coin\src\main\java\org\tenok\coin\data\impl\BybitDAO.java", "Java", 146, 0, 10, 24, 180
"d:\git\CoinTenokProject\tenok-coin\src\main\java\org\tenok\coin\data\websocket\WebsocketResponseEnum.java", "Java", 6, 0, 0, 2, 8
"d:\git\CoinTenokProject\tenok-coin\src\main\java\org\tenok\coin\data\websocket\impl\BybitDecoder.java", "Java", 36, 0, 0, 11, 47
"d:\git\CoinTenokProject\tenok-coin\src\main\java\org\tenok\coin\data\websocket\impl\BybitEncoder.java", "Java", 15, 0, 0, 8, 23
"d:\git\CoinTenokProject\tenok-coin\src\main\java\org\tenok\coin\data\websocket\impl\BybitWebsocket.java", "Java", 112, 0, 13, 30, 155
"d:\git\CoinTenokProject\tenok-coin\src\main\java\org\tenok\coin\data\websocket\impl\BybitWebsocketProcessor.java", "Java", 114, 0, 9, 21, 144
"d:\git\CoinTenokProject\tenok-coin\src\main\java\org\tenok\coin\slack\SlackDAO.java", "Java", 60, 0, 3, 20, 83
"d:\git\CoinTenokProject\tenok-coin\src\main\java\org\tenok\coin\strategy\Strategy.java", "Java", 7, 0, 10, 5, 22
"d:\git\CoinTenokProject\tenok-coin\src\main\java\org\tenok\coin\strategy\StrategyRunner.java", "Java", 31, 0, 0, 11, 42
"d:\git\CoinTenokProject\tenok-coin\src\main\java\org\tenok\coin\strategy\impl\LongStrategy.java", "Java", 20, 0, 4, 8, 32
"d:\git\CoinTenokProject\tenok-coin\src\main\java\org\tenok\coin\strategy\impl\ShortStrategy.java", "Java", 20, 0, 4, 8, 32
"d:\git\CoinTenokProject\tenok-coin\src\main\java\org\tenok\coin\type\CoinEnum.java", "Java", 17, 0, 9, 6, 32
"d:\git\CoinTenokProject\tenok-coin\src\main\java\org\tenok\coin\type\IntervalEnum.java", "Java", 36, 0, 36, 18, 90
"d:\git\CoinTenokProject\tenok-coin\src\main\java\org\tenok\coin\type\OrderTypeEnum.java", "Java", 12, 0, 0, 5, 17
"d:\git\CoinTenokProject\tenok-coin\src\main\java\org\tenok\coin\type\SideEnum.java", "Java", 15, 0, 0, 5, 20
"d:\git\CoinTenokProject\tenok-coin\src\main\java\org\tenok\coin\type\TIFEnum.java", "Java", 14, 0, 3, 5, 22
"d:\git\CoinTenokProject\tenok-coin\src\test\java\org\tenok\coin\AppTest.java", "Java", 6, 0, 3, 5, 14
"d:\git\CoinTenokProject\tenok-coin\src\test\java\org\tenok\coin\DAOTest.java", "Java", 68, 0, 0, 15, 83
"d:\git\CoinTenokProject\tenok-coin\src\test\java\org\tenok\coin\number.java", "Java", 11, 0, 0, 5, 16
"Total", "-", 1600, 137, 181, 429, 2347